1111111111111111111111111111111111
1E0K0000K000000C00000C000000000001
101001010010000010100100K000010101
101001001010101000100100000K010101
1P0000000C00C000000K0000K00K0000C1
1111111111111111111111111111111111
